
Elije un producto nuevo o finaliza pedido = Elije un producto nuevo o finaliza pedido
Añadir menú a pedido = Añadir menú a pedido
Añadir producto individual al pedido = Añadir producto individual al pedido
Finalizar y pagar = Finalizar y pagar
Cancelar pedido = Cancelar pedido
<- = <-
-> = ->
Volver atras = Volver atras
URJC Burger - Bienvenido = URJC Burger - Bienvenido
Nuevo pedido = Nuevo pedido
Cambiar idioma = Cambiar idioma
Seleccione un tipo de producto = Seleccione un tipo de producto
Seleccionar categoría = Seleccionar categoría
Introduce la tarjeta de crédito = Introduce la tarjeta de crédito
Cancelar pago = Cancelar pago
Seleccione un idioma = Seleccione un idioma
Seleccionar idioma = Seleccionar idioma
español = español
ingles = ingles
euskera = euskera
chino = chino
Seleccione un HAMBURGUESAS = Seleccione un HAMBURGUESAS
Seleccione un BEBIDAS = Seleccione un BEBIDAS
Seleccione un COMPLEMENTOS = Seleccione un COMPLEMENTOS
Seleccionar producto = Seleccionar producto
HAMBURGUESAS = HAMBURGUESAS
BEBIDAS = BEBIDAS
COMPLEMENTOS = COMPLEMENTOS
ANGUS = ANGUS
Carne de black angus de 160 g = Carne de black angus de 160 g
Pan de hamburguesa 'BBQ BOURBON' = Pan de hamburguesa 'BBQ BOURBON'
GALLEGA = GALLEGA
Carnes de res rubia Gallega de 160 g = Carnes de res rubia Gallega de 160 g
Panes de hamburguesa 'CRISTAL CROCAN' = Panes de hamburguesa 'CRISTAL CROCAN'
POLLO = POLLO
Chicken supercrujiente = Chicken supercrujiente
Pan brioche, salsa césar coreana = Pan brioche, salsa césar coreana
VEGETAL = VEGETAL
Hecho a base de plantas = Hecho a base de plantas
Pan brioche, salsa césar coreana = Pan brioche, salsa césar coreana
COCA COLA NORMAL = COCA COLA NORMAL
Coca Cola normal = Coca Cola normal
COCA COLA ZERO = COCA COLA ZERO
Coca Cola. Sin azúcar = Coca Cola. Sin azúcar
COCA COLA ZERO ZERO = COCA COLA ZERO ZERO
Coca Cola. Sin azúcar y sin cafeína = Coca Cola. Sin azúcar y sin cafeína
FANTA = FANTA
Fanta Naranja. Sin azúcares = Fanta Naranja. Sin azúcares
AGUA = AGUA
Agua mineral = Agua mineral
CERVEZA = CERVEZA
Cerveza Grande = Cerveza Grande
ALITAS = ALITAS
Alitas de pollo, grandes y sabrosas, para los hambrientos amantes del buen pollo = Alitas de pollo, grandes y sabrosas, para los hambrientos amantes del buen pollo
AROS DE CEBOLLA = AROS DE CEBOLLA
Para compartir, redondos, sabrosos, crujientes y dorados = Para compartir, redondos, sabrosos, crujientes y dorados
PATATAS_SUPREME = PATATAS_SUPREME
Deliciosas Patatas Supreme con la nueva salsa Sour Cream = Deliciosas Patatas Supreme con la nueva salsa Sour Cream
NUGGETS = NUGGETS
Hechos de pollo rebozado, acompañados de estas deliciosas salsas: BBQ, Deluxe, Buffalo y Agridulce = Hechos de pollo rebozado, acompañados de estas deliciosas salsas: BBQ, Deluxe, Buffalo y Agridulce
ENSALADA = ENSALADA
Ensalada de la Huerta con una mezcla de lechuga fresca y los mejores tomatitos cherry. Es el complemento ideal = Ensalada de la Huerta con una mezcla de lechuga fresca y los mejores tomatitos cherry. Es el complemento ideal
APPLE PIE = APPLE PIE
Postre delicioso de pastel de manzana caliente con un toque de canela, envuelto en hojaldre = Postre delicioso de pastel de manzana caliente con un toque de canela, envuelto en hojaldre
SUNDAE CHOCOLATE = SUNDAE CHOCOLATE
Sundae de Chocolate Negro que combina nuestro helado con una rico sirope de chocolate negro = Sundae de Chocolate Negro que combina nuestro helado con una rico sirope de chocolate negro
PIÑA = PIÑA
Deliciosa piña muy refrescante para consumir en cualquier momento del día = Deliciosa piña muy refrescante para consumir en cualquier momento del día
OREO = OREO
Este delicioso postre combina nuestro helado con crujientes trozos de las clásicas galletas Oreo = Este delicioso postre combina nuestro helado con crujientes trozos de las clásicas galletas Oreo
PATATAS FRITAS = PATATAS FRITAS
Las mejores, las más crujientes, las que tienen más sabor = Las mejores, las más crujientes, las que tienen más sabor
NUGGETS_VEGETALES = NUGGETS_VEGETALES
Crujientes, dorados, deliciosos. Los nuggets de toda la vida, con todo su sabor, pero hechos con plantas = Crujientes, dorados, deliciosos. Los nuggets de toda la vida, con todo su sabor, pero hechos con plantas

