Elije un producto nuevo o finaliza pedido = Choose a new product or finish order
Añadir menú a pedido = Add menu to order
Añadir producto individual al pedido = Add individual product to order
Finalizar y pagar = Finish and pay
Cancelar pedido = Cancel order
<- = <-
-> = ->
Volver atras = Go back
URJC Burger - Bienvenido = URJC Burger - Welcome
Nuevo pedido = New order
Cambiar idioma = Change language
Seleccione un tipo de producto = Select a product type
Seleccionar categoría = Select category
Introduce la tarjeta de crédito = Enter credit card
Cancelar pago = Cancel payment
Seleccione un idioma = Select a language
Seleccionar idioma = Select language
español = Spanish
ingles = English
euskera = Basque
chino = Chinese
Seleccione un HAMBURGUESAS = Select a BURGER
Seleccione un BEBIDAS = Select a DRINK
Seleccione un COMPLEMENTOS = Select a SIDE
Seleccionar producto = Select product
HAMBURGUESAS = BURGERS
BEBIDAS = DRINKS
COMPLEMENTOS = SIDES
ANGUS = ANGUS
Carne de black angus de 160 g = 160g Black Angus beef
Pan de hamburguesa 'BBQ BOURBON' = BBQ BOURBON burger bun
GALLEGA = GALICIAN
Carnes de res rubia Gallega de 160 g = 160g Galician blonde beef
Panes de hamburguesa 'CRISTAL CROCAN' = CRISTAL CROCAN burger bun
POLLO = CHICKEN
Chicken supercrujiente = Super crispy chicken
Pan brioche, salsa césar coreana = Brioche bun, Korean caesar sauce
VEGETAL = VEGGIE
Hecho a base de plantas = Plant-based
Pan brioche, salsa césar coreana = Brioche bun, Korean caesar sauce
COCA COLA NORMAL = REGULAR COCA COLA
Coca Cola normal = Regular Coca Cola
COCA COLA ZERO = COCA COLA ZERO
Coca Cola. Sin azúcar = Coca Cola. Sugar free
COCA COLA ZERO ZERO = COCA COLA ZERO ZERO
Coca Cola. Sin azúcar y sin cafeína = Coca Cola. Sugar free and caffeine free
FANTA = FANTA
Fanta Naranja. Sin azúcares = Orange Fanta. Sugar free
AGUA = WATER
Agua mineral = Mineral water
CERVEZA = BEER
Cerveza Grande = Large Beer
ALITAS = WINGS
Alitas de pollo, grandes y sabrosas, para los hambrientos amantes del buen pollo = Large and tasty chicken wings, for hungry chicken lovers
AROS DE CEBOLLA = ONION RINGS
Para compartir, redondos, sabrosos, crujientes y dorados = To share, round, tasty, crispy and golden
PATATAS_SUPREME = SUPREME FRIES
Deliciosas Patatas Supreme con la nueva salsa Sour Cream = Delicious Supreme Fries with new Sour Cream sauce
NUGGETS = NUGGETS
Hechos de pollo rebozado, acompañados de estas deliciosas salsas: BBQ, Deluxe, Buffalo y Agridulce = Made with breaded chicken, accompanied by these delicious sauces: BBQ, Deluxe, Buffalo and Sweet & Sour
ENSALADA = SALAD
Ensalada de la Huerta con una mezcla de lechuga fresca y los mejores tomatitos cherry. Es el complemento ideal = Garden Salad with a mix of fresh lettuce and the best cherry tomatoes. It's the ideal side dish
APPLE PIE = APPLE PIE
Postre delicioso de pastel de manzana caliente con un toque de canela, envuelto en hojaldre = Delicious hot apple pie dessert with a touch of cinnamon, wrapped in puff pastry
SUNDAE CHOCOLATE = CHOCOLATE SUNDAE
Sundae de Chocolate Negro que combina nuestro helado con una rico sirope de chocolate negro = Dark Chocolate Sundae that combines our ice cream with rich dark chocolate syrup
PIÑA = PINEAPPLE
Deliciosa piña muy refrescante para consumir en cualquier momento del día = Delicious refreshing pineapple to enjoy any time of day
OREO = OREO
Este delicioso postre combina nuestro helado con crujientes trozos de las clásicas galletas Oreo = This delicious dessert combines our ice cream with crunchy pieces of classic Oreo cookies
PATATAS FRITAS = FRENCH FRIES
Las mejores, las más crujientes, las que tienen más sabor = The best, the crispiest, the most flavorful
NUGGETS_VEGETALES = VEGGIE NUGGETS
Crujientes, dorados, deliciosos. Los nuggets de toda la vida, con todo su sabor, pero hechos con plantas = Crispy, golden, delicious. The classic nuggets, with all their flavor, but made from plants